$$$$$$$$$$$$$$$$$$$$$$$$$$$$$$$$
$###############2##############$
$##############################$
$##############################$
$##############################$
$##############################$
$##############################$
$##############################$
$##############################$
$##############################$
$##############################$
$##############################$
$##############################$
$##############################$
$##############################$
$##############################$
$##############################$
$##############################$
$###############1##############$
$$$$$$$$$$$$$$$$$$$$$$$$$$$$$$$$
