$$$$$$$$$$$$$$$$$$$$$$$$$$$$$$$$$$$$
$#################2################$
$##################################$
$##################################$
$##################################$
$##################################$
$##################################$
$##################################$
$##################################$
$##################################$
$##################################$
$##################################$
$##################################$
$##################################$
$##################################$
$##################################$
$##################################$
$##################################$
$##################################$
$##################################$
$##################################$
$##################################$
$#################1################$
$$$$$$$$$$$$$$$$$$$$$$$$$$$$$$$$$$$$
