$$$$$$$$$$$$$$$$$$$$$$$$$$$$$$$$
$######$##########$############$
$######$##########$############$
$###2##$##########$#######$####$
$######$$$$$$#####$#######$####$
$######$#################$$$###$
$###$$$$###################$###$
$##########################$###$
$##########################$###$
$$$$$$$$$$$$$$$$$$#############$
$##############################$
$#####################$$$######$
$##########$$$$$$$###$$$#######$
$###############$$$#$$$########$
$$$##############$$$###########$
$#########$#######$$$##########$
$#########$########$$$#####1###$
$#########$#########$$$########$
$#########$##########$$$#######$
$$$$$$$$$$$$$$$$$$$$$$$$$$$$$$$$
