$$$$$$$$$$$$$$$$$$$$$$$$$$$$$$$$
$#####2####$###############$###$
$##########$###############$###$
$####$$$$$$$###############$###$
$##############$$$$$$$$####$###$
$##############$###########$###$
$$$$$$$$$$#####$###############$
$####$#########$###############$
$####$#########$###############$
$####$#########$$$$$$$$$$######$
$#######################$######$
$#######################$$#####$
$####$$$$$$$########$$$$$######$
$##########$###################$
$##########$###################$
$##########$###################$
$##########$##$$$$$$$$$$$$$$$$$$
$##########$###################$
$##########$############1######$
$$$$$$$$$$$$$$$$$$$$$$$$$$$$$$$$
