$$$$$$$$$$$$$$$$$$$$$$$$$$$$$$$$
$#################$######2#####$
$######$##########$############$
$######$######$$$$$########$$$$$
$######$#######################$
$##############################$
$##################$$$$$$$$$###$
$$$$$$#######$$$$$$$$$$$$$#####$
$##############################$
$##############################$
$###########$$$$$$########$$$$$$
$######$#######################$
$########$#####################$
$########$#########$$$$$$######$
$########$#########$###########$
$##################$###########$
$$$$$#######$######$#####$$$$$$$
$###########$######$###########$
$###########$######$#####1#####$
$$$$$$$$$$$$$$$$$$$$$$$$$$$$$$$$
