$$$$$$$$$$$$$$$$$$$$$$$$$$$$$$$$
$####2####################$####$
$#########################$####$
$##############$$#########$####$
$$$$$$$$$$$$$$$$$##############$
$##############################$
$######################$$$$$###$
$############$$################$
$##############################$
$#######$$$$######$$###########$
$######$$$$$$##################$
$#######$$$$###################$
$##########$$$$$$$$$$$$$$$$$$$$$
$##########$############$######$
$##########$############$######$
$##########$############$###1##$
$#################$#####$######$
$#################$############$
$$$$$$$$##########$############$
$$$$$$$$$$$$$$$$$$$$$$$$$$$$$$$$
