$$$$$$$$$$$$$$$$$$$$$$$$$$$$$$$$
$##############################$
$###############2##############$
$##############################$
$##############################$
$##############################$
$#########$$$$$################$
$#########$###$################$
$#########$####################$
$#########$$$$$$$$$$$$$########$
$##############################$
$##############################$
$##############################$
$##############################$
$##############################$
$##############################$
$##############################$
$###############1##############$
$##############################$
$$$$$$$$$$$$$$$$$$$$$$$$$$$$$$$$
