$$$$$$$$$$$$$$$$$$$$$$$$$$$$$$$$
$########$#####################$
$########$##########$$$$$$$$$$$$
$########$##########$$$$$$$$$$$$
$#1######$#####################$
$##############################$
$##############################$
$##############################$
$#############$$$$$$$##########$
$$$$$$##############$##########$
$###################$##########$
$###########$########$#########$
$###########$$########$########$
$###########$$$###########$$$$$$
$###########$$$$###############$
$###########$$$$$##############$
$######$$$$$$$#################$
$######$$$$$$################$$$
$####$$$$$############2########$
$$$$$$$$$$$$$$$$$$$$$$$$$$$$$$$$
